X X X X X X X X X X
X D         X   T X
X   X       X X   X
X X X             X
X   X       X X X X
X   X       X     X
X           X     X
X X X P X X   X X X
X                 X
X X X X X X X X X X